1111111111111
1P00C000E0001
1111111111111