11111111111111111111111
100100C0001C0001C0001C1
110C0111000011000110001
1P0011E10C0011C0011C001
1101000C000CC001CC101C1
11000111100011000110001
10001100C0000C0000C0001
11111111111111111111111